[aiida.calculations]
calculation = aiida.orm.calculation:Calculation
function = aiida.orm.calculation.function:FunctionCalculation
inline = aiida.orm.calculation.inline:InlineCalculation
job = aiida.orm.calculation.job:JobCalculation
simpleplugins.arithmetic.add = aiida.orm.calculation.job.simpleplugins.arithmetic.add:ArithmeticAddCalculation
simpleplugins.templatereplacer = aiida.orm.calculation.job.simpleplugins.templatereplacer:TemplatereplacerCalculation
work = aiida.orm.calculation.work:WorkCalculation

[aiida.cmdline]


[aiida.cmdline.computer.configure]
local = aiida.transport.plugins.local:CONFIGURE_LOCAL_CMD
ssh = aiida.transport.plugins.ssh:CONFIGURE_SSH_CMD

[aiida.code]
code = aiida.orm.code:Code

[aiida.data]
array = aiida.orm.data.array:ArrayData
array.bands = aiida.orm.data.array.bands:BandsData
array.kpoints = aiida.orm.data.array.kpoints:KpointsData
array.projection = aiida.orm.data.array.projection:ProjectionData
array.trajectory = aiida.orm.data.array.trajectory:TrajectoryData
array.xy = aiida.orm.data.array.xy:XyData
bool = aiida.orm.data.bool:Bool
cif = aiida.orm.data.cif:CifData
error = aiida.orm.data.error:Error
float = aiida.orm.data.float:Float
folder = aiida.orm.data.folder:FolderData
frozendict = aiida.orm.data.frozendict:FrozenDict
int = aiida.orm.data.int:Int
list = aiida.orm.data.list:List
orbital = aiida.orm.data.orbital:OrbitalData
parameter = aiida.orm.data.parameter:ParameterData
remote = aiida.orm.data.remote:RemoteData
singlefile = aiida.orm.data.singlefile:SinglefileData
str = aiida.orm.data.str:Str
structure = aiida.orm.data.structure:StructureData
upf = aiida.orm.data.upf:UpfData

[aiida.node]
node = aiida.orm.node:Node

[aiida.parsers]
simpleplugins.arithmetic.add = aiida.parsers.simpleplugins.arithmetic.add:ArithmeticAddParser
simpleplugins.templatereplacer.doubler = aiida.parsers.simpleplugins.templatereplacer.doubler:TemplatereplacerDoublerParser

[aiida.schedulers]
direct = aiida.scheduler.plugins.direct:DirectScheduler
lsf = aiida.scheduler.plugins.lsf:LsfScheduler
pbspro = aiida.scheduler.plugins.pbspro:PbsproScheduler
sge = aiida.scheduler.plugins.sge:SgeScheduler
slurm = aiida.scheduler.plugins.slurm:SlurmScheduler
torque = aiida.scheduler.plugins.torque:TorqueScheduler

[aiida.tests]


[aiida.tools.dbexporters]
tcod = aiida.tools.dbexporters.tcod

[aiida.tools.dbimporters]
cod = aiida.tools.dbimporters.plugins.cod:CodDbImporter
icsd = aiida.tools.dbimporters.plugins.icsd:IcsdDbImporter
materialsproject = aiida.tools.dbimporters.plugins.materialsproject:MaterialsProjectImporter
mpds = aiida.tools.dbimporters.plugins.mpds:MpdsDbImporter
mpod = aiida.tools.dbimporters.plugins.mpod:MpodDbImporter
nninc = aiida.tools.dbimporters.plugins.nninc:NnincDbImporter
oqmd = aiida.tools.dbimporters.plugins.oqmd:OqmdDbImporter
pcod = aiida.tools.dbimporters.plugins.pcod:PcodDbImporter
tcod = aiida.tools.dbimporters.plugins.tcod:TcodDbImporter

[aiida.transports]
local = aiida.transport.plugins.local:LocalTransport
ssh = aiida.transport.plugins.ssh:SshTransport

[aiida.workflows]


[console_scripts]
verdi = aiida.cmdline.commands.cmd_verdi:verdi

