[appurl.urls]
.ipynb = metapack.appurl:JupyterNotebookUrl
index: = metapack.appurl:SearchUrl
metapack+ = metapack.appurl:MetapackUrl
metatab+ = metapack.appurl:MetapackUrl

[console_scripts]
metaaws = metapack.cli.metaaws:metaaws
metasql = metapack.cli.metasql:metasql
metaworld = metapack.cli.metaworld:metaworld
mp = metapack.cli.mp:mp

[mt.subcommands]
build = metapack.cli.build:build
ckan = metapack.cli.metakan:metakan
doc = metapack.cli.doc:doc_args
edit = metapack.cli.edit:edit_args
index = metapack.cli.index:index_args
info = metapack.cli.info:info_args
new = metapack.cli.new:new_args
notebook = metapack.cli.notebook:notebook
open = metapack.cli.open:open_args
run = metapack.cli.run:run
s3 = metapack.cli.s3:s3
search = metapack.cli.search:search
stats = metapack.cli.stats:stats_args
update = metapack.cli.update:update
url = metapack.cli.url:url

[nbconvert.exporters]


[rowgenerators]
<JupyterNotebookUrl> = metapack.rowgenerator:JupyterNotebookSource
<MetapackUrl> = metapack.rowgenerator:MetapackGenerator

